S ./textures/sword.xpm
R 501 391
NO ./textures/north.xpm
SO ./textures/south.xpm      
WE ./textures/west.xpm
EA ./textures/east.xpm
  
  
F 220 ,100 , 0 		
C 225,30,010 

1111111
100001
102001
100001
100001
100N111
100001
111111
