S ./textures/pillar.xpm
	R 900 600



	NO ./textures/north.xpm
           SO ./textures/south.xpm      
WE ./textures/west.xpm
EA 	./textures/east.xpm


		F	 220,100,0 		
   C 			  			225,30,0		
  
1111111111
1000000001
1200000N01
1111111111	



1111111111
1000000001
1200000N01
1111111111	
