S ./textures/sword.xpm
R 900 600
NO ./textures/north.xpm
SO ./textures/south.xpm
WE ./textures/west.xpm
EA ./textures/east.xpm
C 230,90,70
F 100,60,50

111111111111111111111111111111111111111111111111111111111111111111111111111111111111111111111111111
100000000000000020000000000000000000000000000000000000000000000000000000000000000000000000000000001
100000000000000000000000000000000000000000020000000000000000000000000000000000000000000000000000001
100000000020000000000000000000000000000000020000002000020000000000000200000000000000200000000000001
100000000000000000200000000000000000000020000000000000000002000000000000000000000000000000000000001
100000000000000000000000000020000000000000000000000000000000000000000000200000000000000000000000001
100000000000000020000000000000000200000000020000002000000000000000000000000000000000000000000000001
100000000000000000000000000000000000000000000000000000000000000200000000000000000000200000000000001
100000000000000000000000000000000000000002000000000000002000000000000000020000000000000000000000001
100200000000200000000000020000000000000000000000020000000000002000000000000002000000000000000000001
100000000000000000200002000000000200000000000000000000000000020000000000000000000000000000000000001
100000000000000000000000000000000000000000002000000000000000000000000000200000000000000020000000001
100000000000000000000200000000000000000000000002000000000200000000000000000000000000000000000000001
100000000000000000000000000000000000200002000000002000000000000000000000000000000000000000000000001
100000000020000000000000000200002000000000000200000000000020000000000000000000002000000000000000001
100000000000000000000000000000000000000000000000000200000000000000200200000000000000000200000000001
100000000000000000000000000000000002000000000200000000020000000000000200000000000000000000000000001
100000200000000000000200000000200000000020000000000020000000000020000000002000000000000000000000001
100000000000000000000000000200000000000000000000000000000200020000000000000000000000200000020000001
100000000000000002000000000000002000000000000002000000000000002000000000000000000200000000000000001
100000000002000000000000000000000000002000000000000000002000000000000000000000000000000000000000001
100000000000000000000002000000000000000000020000000200000000000200000000000000000000000000000000001
100000000000000000000000000000000002000000000000000000000200002000000002000000000000000200000000001
100000000000000000002000000000000000000002000000000200000000000000000000000000000000000000000000001
100000000000000020000000000000000000000000000000000000000000000000000000000000000000000000000000001
100000000000000000000000000000000000000000020000000000000000000000000000000000000000000000000000001
100000000020000000000000000000000000000000020000002000020000000000000200000000000000200000000000001
100000000000000000200000000000000000000020000000000000000002000000000000000000000000000000000000001
100000000000000000000000000020000000000000000000000000000000000000000000200000000000000000000000001
100000000000000020000000000000000200000000020000002000000000000000000000000000000000000000000000001
100000000000000000000000000000000000000000000000000000000000000200000000000000000000200000000000001
100000000000000000000000000000000000000002000000000000002000000000000000020000000000000000000000001
100200000000200000000000020000000000000000000000020000000000002000000000000002000000000000000000001
100000000000000000200002000000000200000000000000000000000000020000000000000000000000000000000000001
100000000000000000000000000000000000000000002000000000000000000000000000200000000000000020000000001
100000000000000000000200000000000000000000000002000000000200000000000000000000000000000000000000001
100000000000000000000000000000000000200002000000002000000000000000000000000000000000000000000000001
100000000020000000000000000200002000000000000200000000000020000000000000000000002000000000000000001
100000000000000000000000000000000000000000000000000200000000000000200200000000000000000200000000001
100000000000000000000000000000000002000000000200000000020000000000000200000000000000000000000000001
100000200000000000000200000000200000000020000000N00020000000000020000000002000000000000000000000001
100000000000000000000000000200000000000000000000000000000200020000000000000000000000200000020000001
100000000000000002000000000000002000000000000002000000000000002000000000000000000200000000000000001
100000000002000000000000000000000000002000000000000000002000000000000000000000000000000000000000001
100000000000000000000002000000000000000000020000000200000000000200000000000000000000000000000000001
100000000000000000000000000000000002000000000000000000000200002000000002000000000000000200000000001
100000000000000000002000000000000000000002000000000200000000000000000000000000000000000000000000001
100000000000000020000000000000000000000000000000000000000000000000000000000000000000000000000000001
100000000000000000000000000000000000000000020000000000000000000000000000000000000000000000000000001
100000000020000000000000000000000000000000020000002000020000000000000200000000000000200000000000001
100000000000000000200000000000000000000020000000000000000002000000000000000000000000000000000000001
100000000000000000000000000020000000000000000000000000000000000000000000200000000000000000000000001
100000000000000020000000000000000200000000020000002000000000000000000000000000000000000000000000001
100000000000000000000000000000000000000000000000000000000000000200000000000000000000200000000000001
100000000000000000000000000000000000000002000000000000002000000000000000020000000000000000000000001
100200000000200000000000020000000000000000000000020000000000002000000000000002000000000000000000001
100000000000000000200002000000000200000000000000000000000000020000000000000000000000000000000000001
100000000000000000000000000000000000000000002000000000000000000000000000200000000000000020000000001
100000000000000000000200000000000000000000000002000000000200000000000000000000000000000000000000001
100000000000000000000000000000000000200002000000002000000000000000000000000000000000000000000000001
100000000020000000000000000200002000000000000200000000000020000000000000000000002000000000000000001
100000000000000000000000000000000000000000000000000200000000000000200200000000000000000200000000001
100000000000000000000000000000000002000000000200000000020000000000000200000000000000000000000000001
100000200000000000000200000000200000000020000000000020000000000020000000002000000000000000000000001
100000000000000000000000000200000000000000000000000000000200020000000000000000000000200000020000001
100000000000000002000000000000002000000000000002000000000000002000000000000000000200000000000000001
100000000002000000000000000000000000002000000000000000002000000000000000000000000000000000000000001
100000000000000000000002000000000000000000020000000200000000000200000000000000000000000000000000001
100000000000000000000000000000000002000000000000000000000200002000000002000000000000000200000000001
100000000000000000002000000000000000000002000000000200000000000000000000000000000000000000000000001
100000000000000020000000000000000000000000000000000000000000000000000000000000000000000000000000001
100000000000000000000000000000000000000000020000000000000000000000000000000000000000000000000000001
100000000020000000000000000000000000000000020000002000020000000000000200000000000000200000000000001
100000000000000000200000000000000000000020000000000000000002000000000000000000000000000000000000001
100000000000000000000000000020000000000000000000000000000000000000000000200000000000000000000000001
100000000000000020000000000000000200000000020000002000000000000000000000000000000000000000000000001
100000000000000000000000000000000000000000000000000000000000000200000000000000000000200000000000001
100000000000000000000000000000000000000002000000000000002000000000000000020000000000000000000000001
100200000000200000000000020000000000000000000000020000000000002000000000000002000000000000000000001
100000000000000000200002000000000200000000000000000000000000020000000000000000000000000000000000001
100000000000000000000000000000000000000000002000000000000000000000000000200000000000000020000000001
100000000000000000000200000000000000000000000002000000000200000000000000000000000000000000000000001
100000000000000000000000000000000000200002000000002000000000000000000000000000000000000000000000001
100000000020000000000000000200002000000000000200000000000020000000000000000000002000000000000000001
100000000000000000000000000000000000000000000000000200000000000000200200000000000000000200000000001
100000000000000000000000000000000002000000000200000000020000000000000200000000000000000000000000001
100000200000000000000200000000200000000020000000000020000000000020000000002000000000000000000000001
100000000000000000000000000200000000000000000000000000000200020000000000000000000000200000020000001
100000000000000002000000000000002000000000000002000000000000002000000000000000000200000000000000001
100000000002000000000000000000000000002000000000000000002000000000000000000000000000000000000000001
100000000000000000000002000000000000000000020000000200000000000200000000000000000000000000000000001
100000000000000000000000000000000002000000000000000000000200002000000002000000000000000200000000001
100000000000000000002000000000000000000002000000000200000000000000000000000000000000000000000000001
111111111111111111111111111111111111111111111111111111111111111111111111111111111111111111111111111
