S ./textures/sword.xpm
R 10000000000 10000000000
NO ./textures/north.xpm
SO ./textures/south.xpm      
WE ./textures/west.xpm
EA ./textures/east.xpm
  
  
F 220,100,0 		
C 225,30,0 

1111111
100N111
100001
111111
