S ./textures/sword.xpm
R 1200 900

NO ./textures/c_north.xpm
SO ./textures/c_south.xpm
WE ./textures/c_west.xpm
EA ./textures/c_east.xpm
C 230,90,70
F 100,60,50
11111111111
10000000001
10001200001
100010010 11110
100100001000001111
10000N000000000001
10000000000111111
100100010010
10000000001
11111111111	
